00000010000000001000
0000C00100000E0000101
0001000000A001000000
00010000011001000000
00011110011001111000
00000010011000001000
0000001000000D0001000
00010000000001000000
00010000B000001000000