00000010000000001000
0000C0100000E0001000
0001000000A001000000
00010000022001000000
00011110011001111000
00000010011000001000
0000001000000D001000
00010000000001000000
00010000B00001000000