00000010000000001000
00000010000000001000
00010000000001000000
00010000011001000000
00011110011001111000
00000010011000001000
00000010000000001000
00010000000001000000
00010000000001000000
endmap;