00000010000000001000
0000C0100000E0001000
0001000000A002000000
00010000022001000000
00011110011001111000
00000010011000001000
00000010000B0D001000
00010000000010000000
00010000000010000000